SSSSSSSSSSSSSSSS
SSSSIIIIIIIISSSS
SSSSIIIIIIIISSSS
SSSSSSSSSIIISSSS
SSSSFFCLSSSIISSS
SSSSFCCLSSSSSSSS
SSSSSSSSSSSSSSSS
SSSSLLLLLLLCCSSS
SSSSSLFFFLLLCCSS
SSSSSLFFFLLLCCSS
SSSSLLLLLLLCCSSS
SSSSSLCCCCCCCCSS
SSSSSLCCCCCCCCSS
SSSSLLLLLLLLLSSS
SSSSSSSSSSSSSSSS